(reference:fill-doc	(/api-reference/docgen/fill-doc
(doc:instruct	(/llm-based-extractions/prompt-tips/index-instruct
(doc:batch-api	(/beta/batch-api
(doc:document-generation-intro	(/beta/document-generation-intro
(doc:prompt	(/llm-based-extractions/prompt
(doc:author	(/welcome/author
(doc:integrate	(/welcome/integrate
(doc:sections-example-zip	(/senseml-reference/sections/sections-example-zip
(doc:getting-started-ai	(/welcome/getting-started-ai
(doc:sections-example-table-grid	(/senseml-reference/sections/sections-example-table-grid
(doc:sections-example-nested-table	(/senseml-reference/sections/sections-example-nested-table
(doc:sections-example-nested-columns	(/senseml-reference/sections/sections-example-nested-columns
(doc:sections-example-loss-run	(/senseml-reference/sections/sections-example-loss-run
(doc:sections-example-labeled-rows	(/senseml-reference/sections/sections-example-labeled-rows
(doc:sections-example-external-range	(/senseml-reference/sections/sections-example-external-range
(doc:sections-example-copy-to-section	(/senseml-reference/sections/sections-example-copy-to-section
(doc:sections-example-copy-from-sections	(/senseml-reference/sections/sections-example-copy-from-sections
(doc:split-lines	(/senseml-reference/preprocessors/split-lines
(doc:scale	(/senseml-reference/preprocessors/scale
(doc:rotate-page	(/senseml-reference/preprocessors/rotate-page
(doc:remove-header	(/senseml-reference/preprocessors/remove-header
(doc:remove-footer	(/senseml-reference/preprocessors/remove-footer
(doc:page-range	(/senseml-reference/preprocessors/page-range
(doc:ocr-preprocessor	(/senseml-reference/preprocessors/ocr-preprocessor
(doc:nlp	(/senseml-reference/preprocessors/nlp
(doc:merge-lines	(/senseml-reference/preprocessors/merge-lines
(doc:ligature	(/senseml-reference/preprocessors/ligature
(doc:deskew	(/senseml-reference/preprocessors/deskew
(doc:text-table	(/senseml-reference/methods/text-table
(doc:signature	(/senseml-reference/methods/signature
(doc:row	(/senseml-reference/methods/row
(doc:region	(/senseml-reference/methods/region
(doc:regex	(/senseml-reference/methods/regex
(doc:passthrough	(/senseml-reference/methods/passthrough
(doc:paragraph	(/senseml-reference/methods/paragraph
(doc:nearest-checkbox	(/senseml-reference/methods/nearest-checkbox
(doc:label	(/senseml-reference/methods/label
(doc:intersection	(/senseml-reference/methods/intersection
(doc:fixed-table	(/senseml-reference/methods/fixed-table
(doc:document-range	(/senseml-reference/methods/document-range
(doc:column	(/senseml-reference/methods/column
(doc:checkbox	(/senseml-reference/methods/checkbox
(doc:box	(/senseml-reference/methods/box
(doc:summarizer	(/senseml-reference/llm-based-methods/summarizer
(doc:query-group	(/senseml-reference/llm-based-methods/query-group
(doc:nlp-table	(/senseml-reference/llm-based-methods/nlp-table
(doc:list	(/senseml-reference/llm-based-methods/list
(doc:types	(/senseml-reference/field-query-object/types
(doc:method	(/senseml-reference/field-query-object/method
(doc:match	(/senseml-reference/field-query-object/match
(doc:anchor	(/senseml-reference/field-query-object/anchor
(doc:ocr-level	(/senseml-reference/document-type-settings/ocr-level
(doc:ocr-engine	(/senseml-reference/document-type-settings/ocr-engine
(doc:fingerprint-mode	(/senseml-reference/document-type-settings/fingerprint-mode
(doc:verbosity	(/senseml-reference/config-settings/verbosity
(doc:fingerprint	(/senseml-reference/config-settings/fingerprint
(doc:table-methods	(/senseml-reference/concepts/table-methods
(doc:senseml	(/senseml-reference/concepts/senseml
(doc:section-nuances	(/senseml-reference/concepts/section-nuances
(doc:ocr	(/senseml-reference/concepts/ocr
(doc:match-arrays	(/senseml-reference/concepts/match-arrays
(doc:lines	(/senseml-reference/concepts/lines
(doc:ligatures	(/senseml-reference/concepts/ligatures
(doc:file-types	(/senseml-reference/concepts/file-types
(doc:field-order	(/senseml-reference/concepts/field-order
(doc:coverage	(/senseml-reference/concepts/coverage
(doc:anchor-nuances	(/senseml-reference/concepts/anchor-nuances
(doc:accuracy-measures	(/senseml-reference/concepts/accuracy-measures
(doc:zip	(/senseml-reference/computed-field-methods/zip
(doc:suppress-output	(/senseml-reference/computed-field-methods/suppress-output
(doc:split	(/senseml-reference/computed-field-methods/split
(doc:pick-values	(/senseml-reference/computed-field-methods/pick-values
(doc:mapper	(/senseml-reference/computed-field-methods/mapper
(doc:constant	(/senseml-reference/computed-field-methods/constant
(doc:concatenate	(/senseml-reference/computed-field-methods/concatenate
(doc:get-file-metadata	(/senseml-reference/advanced-computed-field-methods/get-file-metadata
(doc:custom-computation	(/senseml-reference/advanced-computed-field-methods/custom-computation
(doc:copy-to-section	(/senseml-reference/advanced-computed-field-methods/copy-to-section
(doc:copy-from-sections	(/senseml-reference/advanced-computed-field-methods/copy-from-sections
(doc:add-computed-fields	(/senseml-reference/advanced-computed-field-methods/add-computed-fields
(doc:senseml-reference-introduction	(/senseml-reference/senseml-reference-introduction
(doc:table-tips	(/llm-based-extractions/prompt-tips/table-tips
(doc:query-group-tips	(/llm-based-extractions/prompt-tips/query-group-tips
(doc:list-tips	(/llm-based-extractions/prompt-tips/list-tips
(doc:ui	(/layout-based-extractions/app-guide/ui
(doc:color	(/layout-based-extractions/app-guide/color
(doc:repeat-layouts	(/layout-based-extractions/repeat-layouts
(doc:portfolio	(/layout-based-extractions/portfolio
(doc:library-quickstart	(/layout-based-extractions/library-quickstart
(doc:getting-started	(/layout-based-extractions/getting-started
(doc:zapier-tutorial-2	(/integrations/zapier/zapier-tutorial-2
(doc:zapier-getting-started	(/integrations/zapier/zapier-getting-started
(doc:excel-reference	(/integrations/quick-extraction/excel-reference
(doc:sdk-guides	(/integrations/sdk-guides
(doc:quickstart	(/integrations/quickstart
(doc:classify	(/document-type-classification/classify
(doc:troubleshoot	(/best-practices/tutorials/troubleshoot
(doc:test-before-integrating-configs	(/best-practices/tutorials/test-before-integrating-configs
(doc:performance	(/best-practices/tutorials/performance
(doc:handwriting	(/best-practices/tutorials/handwriting
(doc:go-live	(/best-practices/tutorials/go-live
(doc:fallbacks	(/best-practices/tutorials/fallbacks
(doc:validate-extractions	(/best-practices/validate-extractions
(doc:troubleshoot-llms	(/best-practices/troubleshoot-llms
(doc:metrics	(/best-practices/metrics
(doc:confidence	(/best-practices/confidence
(doc:api-tutorial-webhook	(/api-guides/api-tutorial/api-tutorial-webhook
(doc:api-tutorial-sync	(/api-guides/api-tutorial/api-tutorial-sync
(doc:api-tutorial-async-2	(/api-guides/api-tutorial/api-tutorial-async-2
(doc:api-tutorial-async-1	(/api-guides/api-tutorial/api-tutorial-async-1
(doc:examples	(/api-guides/examples
(doc:api-reference	(/api-guides/api-reference
(reference:classify-document	(/api-reference/classification/document/classify-document
(reference:classify-document-sync	(/api-reference/classification/document/classify-document-sync
(reference:choosing-an-endpoint	(/api-reference/choosing-an-endpoint
(reference:authentication	(/api-reference/authentication
(reference:retrieving-results	(/api-reference/extraction/retrieve-extractions/retrieving-results
(reference:list-extractions	(/api-reference/extraction/retrieve-extractions/list-extractions
(reference:statistics	(/api-reference/extraction/retrieve-extractions/statistics
(reference:extract-from-url-portfolio	(/api-reference/extraction/portfolio/extract-from-url-portfolio
(reference:generate-upload-url-portfolio	(/api-reference/extraction/portfolio/generate-upload-url-portfolio
(reference:get-excel-extraction	(/api-reference/extraction/get-excel-from-documents/get-excel-extraction
(reference:get-csv-extraction	(/api-reference/extraction/get-excel-from-documents/get-csv-extraction
(reference:extract-from-url	(/api-reference/extraction/document/extract-from-url
(reference:provide-a-download-url-with-config	(/api-reference/extraction/document/provide-a-download-url-with-config
(reference:generate-upload-url	(/api-reference/extraction/document/generate-upload-url
(reference:generate-an-upload-url-with-config	(/api-reference/extraction/document/generate-an-upload-url-with-config
(reference:extract-data-from-a-document-with-config	(/api-reference/extraction/document/extract-data-from-a-document-with-config
(reference:extract-data-from-a-document	(/api-reference/extraction/document/extract-data-from-a-document
(reference:update-reference-document	(/api-reference/configuration/reference-document/update-reference-document
(reference:delete-reference-document-association	(/api-reference/configuration/reference-document/delete-reference-document-association
(reference:list-reference-documents	(/api-reference/configuration/reference-document/list-reference-documents
(reference:get-reference-document	(/api-reference/configuration/reference-document/get-reference-document
(reference:extract-all-text-from-reference-document	(/api-reference/configuration/reference-document/extract-all-text-from-reference-document
(reference:delete-reference-document	(/api-reference/configuration/reference-document/delete-reference-document
(reference:create-reference-document	(/api-reference/configuration/reference-document/create-reference-document
(reference:update-document-type	(/api-reference/configuration/document-type/update-document-type
(reference:list-document-types	(/api-reference/configuration/document-type/list-document-types
(reference:get-document-type	(/api-reference/configuration/document-type/get-document-type
(reference:delete-document-type	(/api-reference/configuration/document-type/delete-document-type
(reference:create-document-type	(/api-reference/configuration/document-type/create-document-type
(reference:update-configuration	(/api-reference/configuration/configuration/update-configuration
(reference:publish-configuration-by-version	(/api-reference/configuration/configuration/publish-configuration-by-version
(reference:get-configuration-versions	(/api-reference/configuration/configuration/get-configuration-versions
(reference:list-configurations	(/api-reference/configuration/configuration/list-configurations
(reference:get-configuration	(/api-reference/configuration/configuration/get-configuration
(reference:get-configuration-by-version	(/api-reference/configuration/configuration/get-configuration-by-version
(reference:delete-configuration-by-version	(/api-reference/configuration/configuration/delete-configuration-by-version
(reference:delete-configuration	(/api-reference/configuration/configuration/delete-configuration
(reference:create-configuration	(/api-reference/configuration/configuration/create-configuration
(doc:methods	(/senseml-reference/methods/index-methods
(doc:llm-based-methods	(/senseml-reference/llm-based-methods/index-llm-based-methods
(doc:field-query-object	(/senseml-reference/field-query-object/index-field-query-object
(doc:document-type-settings	(/senseml-reference/document-type-settings/index-document-type-settings
(doc:config-settings	(/senseml-reference/config-settings/index-config-settings
(doc:concepts	(/senseml-reference/concepts/index-concepts
(doc:computed-field-methods	(/senseml-reference/computed-field-methods/index-computed-field-methods
(doc:advanced-computed-field-methods	(/senseml-reference/advanced-computed-field-methods/index-advanced-computed-field-methods
(doc:prompt-tips	(/llm-based-extractions/prompt-tips/index-prompt-tips
(doc:app-guide	(/layout-based-extractions/app-guide/index-app-guide
(doc:zapier	(/integrations/zapier/index-zapier
(doc:quick-extraction	(/integrations/quick-extraction/index-quick-extraction
(doc:tutorials	(/best-practices/tutorials/index-tutorials
(doc:api-tutorial	(/api-guides/api-tutorial/index-api-tutorial
(doc:sections	(/senseml-reference/sections/index-sections
(doc:preprocessors	(/senseml-reference/preprocessors/index-preprocessors
(doc:bag-of-words	(/senseml-reference/deprecated-features/deprecated-bag-of-words
(doc:deprecated-bag-of-words	(/senseml-reference/deprecated-features/deprecated-bag-of-words
(doc:page-filter	(/senseml-reference/deprecated-features/deprecated-page-filter
(doc:deprecated-page-filter	(/senseml-reference/deprecated-features/deprecated-page-filter
(doc:topic	(/senseml-reference/deprecated-features/deprecated-topic
(doc:deprecated-topic	(/senseml-reference/deprecated-features/deprecated-topic
(doc:invoice	(/senseml-reference/deprecated-features/deprecated-invoice
(doc:deprecated-invoice	(/senseml-reference/deprecated-features/deprecated-invoice
(doc:tfidf	(/senseml-reference/deprecated-features/deprecated-tfidf
(doc:deprecated-tfidf	(/senseml-reference/deprecated-features/deprecated-tfidf
(doc:key-value	(/senseml-reference/deprecated-features/deprecated-key-value
(doc:deprecated-key-value	(/senseml-reference/deprecated-features/deprecated-key-value
(doc:table	(/senseml-reference/llm-based-methods/nlp-table
(doc:deprecated-table	(/senseml-reference/deprecated-features/deprecated-table
(doc:query-tips	(/llm-based-extractions/prompt-tips/query-group-tips
(doc:query	(/senseml-reference/llm-based-methods/query-group
(doc:deprecated-query	(/senseml-reference/deprecated-features/deprecated-query
(doc:overview	(/welcome/getting-started-ai
(doc:no-code	(/welcome/getting-started-ai
(doc:developer	(/welcome/integrate
(doc:excel-quickstart	(/layout-based-extractions/library-quickstart
(doc:excel	(/integrations/quick-extraction/index-quick-extraction
(doc:sdk-quickstarts	(/integrations/sdk-guides
(doc:advanced-methods	(/senseml-reference/methods/index-methods
(doc:natural-language-methods	(/senseml-reference/llm-based-methods/index-llm-based-methods
(doc:guides	(/best-practices/tutorials/index-tutorials
